Krok,Zdrowi,Odporni,Chorzy - faza 1,Chorzy - faza 2,Populacja,Chorzy ogółem
0,385,95,48,55,488,103
1,387,43,76,48,511,124
2,369,36,87,75,531,162
3,332,54,95,83,510,178
4,283,59,85,87,455,172
5,240,61,70,75,385,145
6,184,48,54,58,296,112
7,138,37,40,44,222,84
8,125,33,33,36,194,69
9,104,26,26,29,159,55
10,88,22,18,22,128,40
11,75,17,12,15,102,27
12,65,11,8,10,83,18
13,52,8,6,7,65,13
14,42,6,3,5,50,8
15,34,4,0,2,36,2
16,25,2,0,0,25,0
